XXXXXXXX
X......X
X.P....X
X......X
X......X
X._....X
X......X
XXXXXXXX
