XXXXXXXX
X....._X
X.XX.XXX
X...X..X
XXX....X
X.PXXX.X
X......X
XXXXXXXX
