XXXXXXXXX
XP..X...X
X.X...X.X
X.XXX.X.X
X.......X
XX....X.X
X..XX...X
X.X_..X.X
XXXXXXXXX
